0000000000000000000000000000000000000000
0                                      0
0                                      0
0        2                             0
0                             1111111110
0                             1111211110
0                             1111111110
0                                      0
0                                      0
0                                      0
0                                      0
011111111111100000000000000            0
0111112111111                          0
0111111111111                    2     0
0                                      0
0                   11111111111111111110
0                   11111111111111111110
0                   11111111111111111110
0                                      0
0                                      0
0                                      0
0              11111                   0
01111111111111111111                   0
01111111111111111111                   0
0                                      0
0          2                           0
0                         11111111111110
0                         11111111111110
0                         11111111111110
0000000000000000000000000000000000000000
